date,positive_count,positive_score,negative_count,negative_score,total_count,total_score
20160104,32,0.6412499994,5,0.2919999972,37,0.4883333374
20160105,22,0.7118181749,1,0.3100000024,23,0.484210525
20160106,32,0.7656249981,2,0.2399999937,34,0.756000018
20160107,32,0.7209375016,21,0.2890476176,53,0.5033333202
20160108,60,0.656499998,19,0.2400000008,79,0.5339999914
20160109,2,0.7050000131,13,0.2569230806,15,0.6266666651
20160110,5,0.7459999919,18,0.27,23,0.3843750046
20160111,9,0.7011111114,91,0.2195604378,100,0.6025
20160112,56,0.6592857114,10,0.1679999966,66,0.567222226
20160113,13,0.693846157,9,0.175555558,22,0.6235714289
20160114,17,0.603529411,49,0.2895918397,66,0.5741666555
20160115,8,0.668750003,74,0.3201351341,82,0.6900000036
20160117,10,0.6629999995,21,0.3557142835,31,0.6299999952
20160118,10,0.6770000041,34,0.2688235296,44,0.6739999831
20160119,23,0.6243478241,10,0.3159999996,33,0.368333331
20160120,17,0.6876470587,6,0.3783333351,23,0.5833333333
20160121,9,0.674444437,11,0.225454547,20,0.7092857083
20160122,9,0.7211111122,16,0.2774999999,25,0.5016981123
20160123,3,0.6400000056,19,0.2757894738,22,0.4931707284
20160124,10,0.6790000081,14,0.2900000007,24,0.6186666664
20160125,12,0.660833329,25,0.2940000015,37,0.558600001
20160126,17,0.6835294085,4,0.2799999961,21,0.393178806
20160127,23,0.6282608665,17,0.2335294126,40,0.2574999994
20160128,96,0.603437497,14,0.2642857124,110,0.379285713
20160129,7,0.6528571333,17,0.334117647,24,0.3534482784
20160131,11,0.6890909022,166,0.3046987944,177,0.4662307674
20160201,70,0.6064285721,44,0.21159091,114,0.485
20160202,47,0.6414893587,3,0.1133333345,50,0.3803921568
20160203,75,0.6174666611,2,0.3700000048,77,0.4727777789
20160204,33,0.6360605937,124,0.3098387091,157,0.55625
20160205,20,0.6820000082,81,0.3107407416,101,0.4404761932
20160206,5,0.7599999905,64,0.2107812476,69,0.4820512808
20160207,1,0.5699999928,57,0.3166666644,58,0.4702777778
20160208,6,0.6066666742,21,0.3185714281,27,0.4404347801
20160209,11,0.7663636262,7,0.2057142896,18,0.4070588249
20160210,52,0.6707692307,25,0.3319999993,77,0.6400000056
20160211,76,0.7165789392,25,0.2439999998,101,0.5650000047
20160212,23,0.636086951,56,0.322678571,79,0.4103448263
20160213,10,0.5299999714,53,0.3228301892,63,0.4941935458
20160214,52,0.6623076946,34,0.306470587,86,0.5032499982
20160215,75,0.6460000006,7,0.3228571372,82,0.4141603037
20160216,111,0.7279279243,16,0.3593750028,127,0.2721568622
20160217,189,0.665026455,136,0.2888235292,325,0.1133333345
20160218,170,0.7086470611,61,0.2801639318,231,0.6399999949
20160219,93,0.6304301088,158,0.3453797466,251,0.41685567
20160220,2,0.625,43,0.3862790684,45,0.4321874994
20160221,150,0.6840666684,37,0.3108108111,187,0.4302158233
20160222,159,0.7023270423,9,0.1933333282,168,0.4337777718
20160223,101,0.655940595,110,0.2612727275,211,0.4958536623
20160224,128,0.698203119,95,0.2745263165,223,0.436666665
20160225,165,0.6914545485,68,0.3554411787,233,0.3411538452
20160226,59,0.663728817,86,0.2822093037,145,0.6066666742
20160227,10,0.8160000026,37,0.2137837817,47,0.4036111078
20160228,50,0.6638000011,23,0.2265217384,73,0.4902777775
20160229,24,0.7379166683,8,0.3737500049,32,0.554806197
20160301,104,0.7301923008,50,0.2250000036,154,0.4394736813
20160302,177,0.662033902,69,0.3452173911,246,0.4447058632
20160303,145,0.627241378,19,0.3005263158,164,0.5910294141
20160304,83,0.7463855528,158,0.3074683535,241,0.4157819906
20160305,5,0.7200000286,75,0.317733334,80,0.5691279037
20160306,54,0.6068518493,27,0.2944444418,81,0.5194812679
20160307,72,0.6848611095,42,0.3511904756,114,0.6435680766
20160308,48,0.6464583228,42,0.3278571424,90,0.5394615394
20160309,56,0.5958928551,38,0.2594736832,94,0.2718181776
20160310,99,0.6549494965,98,0.2246938775,197,0.5051923088
20160311,108,0.6299999985,69,0.3930434746,177,0.5423228338
20160312,6,0.5883333385,192,0.3269791645,198,0.5350295874
20160313,47,0.6829787239,22,0.3195454607,69,0.5310280343
20160314,118,0.670677966,23,0.332173913,141,0.6039603982
20160315,66,0.623333334,58,0.3570689605,124,0.5410975633
20160316,86,0.6902325569,103,0.3446601953,189,0.6194444481
20160317,105,0.6432380932,96,0.2404166671,201,0.4444000024
20160318,200,0.6713499975,272,0.2716911742,472,0.44655914
20160319,41,0.696097559,135,0.3388888868,176,0.6638211324
20160320,64,0.6562500047,10,0.2800000012,74,0.4948059717
20160321,97,0.7718556702,39,0.30307692,136,0.5217272721
20160322,62,0.6969354758,72,0.2090277793,134,0.635454553
20160323,77,0.644155846,75,0.2409333344,152,0.7200000286
20160324,75,0.6673333343,64,0.357968746,139,0.4949999983
20160325,27,0.7537037046,41,0.254634146,68,0.5533333322
20160326,20,0.5599999875,51,0.293921567,71,0.47546511
20160327,57,0.6061403459,22,0.3654545437,79,0.3596753239
20160328,86,0.6256976765,67,0.3508955217,153,0.5473809518
20160329,52,0.6517307781,44,0.3463636367,96,0.4360666648
20160330,109,0.6398165051,33,0.3400000009,142,0.3771428631
20160331,40,0.631499994,154,0.3011038935,194,0.567714286
20160401,30,0.599999992,103,0.2830097073,133,0.5673295437
20160402,6,0.5299999714,64,0.2332812476,70,0.4534911252
20160403,56,0.6548214225,2,0.449999988,58,0.452967033
20160404,32,0.695937505,31,0.2980645157,63,0.3751724115
20160405,67,0.6620895507,80,0.2612499997,147,0.537373132
20160406,34,0.689117642,87,0.242758621,121,0.614509802
20160407,234,0.6436324761,117,0.2508547018,351,0.5225242737
20160408,64,0.582343745,125,0.332559999,189,0.5320710066
20160409,1,0.5299999714,75,0.3678666682,76,0.447299267
20160410,87,0.6335632178,82,0.3115853689,169,0.5142553182
20160411,208,0.6459615382,137,0.2589051092,345,0.5214655177
20160412,114,0.6463157885,42,0.3023809519,156,0.4530769223
20160413,44,0.5763636326,10,0.4000000015,54,0.4580952312
20160414,82,0.6871951201,14,0.291428574,96,0.4682258038
20160415,82,0.7452439019,30,0.3719999954,112,0.5311538477
20160416,11,0.6990908926,10,0.4050000012,21,0.5307058881
20160417,30,0.7080000043,26,0.1780769225,56,0.4414828846
20160418,85,0.6572941226,51,0.3478431347,136,0.3804895077
20160419,256,0.6916406208,94,0.268085105,350,0.3503191448
20160420,64,0.6360937422,105,0.2654285691,169,0.5099999756
20160421,116,0.6862930995,65,0.2138461529,181,0.5277011454
20160422,113,0.7008849578,36,0.2497222225,149,0.3854464298
20160423,25,0.774000001,6,0.071666668,31,0.4251948045
20160424,29,0.6237931046,33,0.2809090894,62,0.3495364234
20160425,129,0.6904651158,67,0.3159701511,196,0.5353203323
20160426,137,0.6587591223,299,0.1586287621,436,0.466618704
20160427,96,0.6677083323,111,0.2448648649,207,0.5299999714
20160428,169,0.6521893486,198,0.2817676747,367,0.4773372793
20160429,19,0.6831578895,67,0.2840298503,86,0.4922608693
20160501,24,0.7241666615,12,0.3183333303,36,0.553717948
20160502,68,0.6476470565,7,0.2242857122,75,0.5437037009
20160503,118,0.6854237288,142,0.2115492953,260,0.6294791654
20160504,109,0.6557798079,109,0.3310091754,218,0.6452678555
20160505,79,0.68987342,90,0.3133333331,169,0.559047611
20160506,86,0.707209297,26,0.284999998,112,0.4619642877
20160507,21,0.6995238208,77,0.1879220771,98,0.5412500021
20160508,41,0.6426829245,12,0.307500001,53,0.5778857108
20160509,148,0.6833108132,10,0.2749999948,158,0.4057988122
20160510,155,0.6958709663,37,0.3924324346,192,0.5166298314
20160511,59,0.7062711877,40,0.2557500041,99,0.591879196
20160512,59,0.7122033895,27,0.2125925948,86,0.6380645172
20160513,62,0.67241935,33,0.1812121193,95,0.4412903223
20160514,25,0.6779999971,54,0.3118518522,79,0.5624489799
20160515,38,0.664473683,10,0.4099999964,48,0.3157798157
20160516,58,0.632586212,62,0.323870968,120,0.4409661831
20160517,72,0.6737499974,87,0.3268965506,159,0.4523433229
20160518,191,0.6438219925,129,0.2806201528,320,0.3722093008
20160519,51,0.6662745102,120,0.2881666669,171,0.3183333303
20160520,33,0.743333329,80,0.1994999997,113,0.6112903181
20160521,5,0.7300000191,17,0.241764705,22,0.3527619037
20160522,119,0.7081512588,15,0.3399999887,134,0.5152422913
20160523,105,0.6592380938,45,0.2679999994,150,0.5009045178
20160524,59,0.653389825,92,0.3418478294,151,0.5896190489
20160525,113,0.645486727,70,0.3561428597,183,0.4619018371
20160526,87,0.643218394,116,0.2649999996,203,0.5569697045
20160527,129,0.7004651145,90,0.2620000011,219,0.5705882324
20160528,5,0.7699999809,20,0.3574999969,25,0.6251351375
20160529,13,0.6230769112,12,0.094999999,25,0.6055897433
20160530,80,0.7220000088,50,0.3039999997,130,0.5512790714
20160531,101,0.635445547,74,0.2889189215,175,0.5217391295
20160601,134,0.6720149197,82,0.3248780483,216,0.5045689631
20160602,187,0.6726737969,31,0.3680645141,218,0.6014285684
20160603,64,0.6610937463,37,0.2743243243,101,0.4532999995
20160605,85,0.652941173,44,0.3115909079,129,0.4491724152
20160606,50,0.629799987,10,0.3919999942,60,0.4214427837
20160607,136,0.6671323548,85,0.394941177,221,0.5065916418
20160608,141,0.6525531902,82,0.344999997,223,0.381221374
20160609,51,0.6319607824,40,0.255749998,91,0.5727999966
20160610,67,0.6274626878,29,0.2524137886,96,0.4374999963
20160611,11,0.5972727266,21,0.2557142881,32,0.587378047
20160612,52,0.6684615291,46,0.3389130419,98,0.5110152292
20160613,147,0.7214285727,105,0.2657142859,252,0.492093022
20160614,110,0.6193636352,79,0.324556962,189,0.4527510923
20160615,134,0.6273880565,77,0.2236363645,211,0.4493785332
20160616,51,0.6213725478,95,0.3194736844,146,0.6544295283
20160617,96,0.692291667,6,0.1900000051,102,0.7699999809
20160618,15,0.6666666667,9,0.2699999929,24,0.3695999933
20160619,66,0.63833334,41,0.299024389,107,0.5612307746
20160620,50,0.6471999931,93,0.3335483899,143,0.4889142882
20160621,83,0.643253009,34,0.2914705904,117,0.5402314778
20160622,112,0.7416071407,20,0.3399999961,132,0.629357798
20160623,78,0.7037179592,26,0.2769230772,104,0.5194059382
20160624,38,0.7286842058,47,0.2265957483,85,0.5365116252
20160626,66,0.6677272699,7,0.358571423,73,0.5901666549
20160627,67,0.7358208886,46,0.2034782597,113,0.5624434403
20160628,76,0.7243421062,21,0.2885714276,97,0.5394618815
20160629,58,0.6789655151,32,0.2799999991,90,0.4665934046
20160630,70,0.6964285714,82,0.280243904,152,0.5141666662
20160701,83,0.6331325209,93,0.2168817193,176,0.5972727266
20160703,65,0.7009230806,2,0.1499999985,67,0.5497260214
20160704,104,0.640865385,32,0.3459374985,136,0.630259068
20160705,122,0.6731147512,130,0.2872307689,252,0.4466511623
20160706,137,0.6829197033,220,0.2382272719,357,0.5150704205
20160707,145,0.64813793,106,0.2605660375,251,0.3821093751
20160708,61,0.6777049137,125,0.3249599997,186,0.506858639
20160710,39,0.7038461597,86,0.256627906,125,0.5304761919
20160711,72,0.6808333306,5,0.4600000083,77,0.594133338
20160712,36,0.7094444335,27,0.2703703658,63,0.490329666
20160713,64,0.6389062507,88,0.3270454556,152,0.4796022728
20160714,60,0.7553333312,56,0.2737499993,116,0.6367808208
20160715,51,0.6664705919,115,0.2356521728,166,0.6294898035
20160716,2,0.6049999893,265,0.2651320752,267,0.5451562473
20160717,55,0.6679999958,129,0.2716279071,184,0.2265957483
20160718,68,0.699558816,14,0.2121428624,82,0.6380821887
20160719,84,0.6866666696,23,0.360869565,107,0.5191150397
20160720,120,0.660999995,100,0.1792999993,220,0.6300000005
20160721,67,0.6204477593,286,0.193916085,353,0.5371111094
20160722,3,0.7333333095,160,0.2218749996,163,0.4719078956
20160724,9,0.7177777621,146,0.2325342443,155,0.4131818132
20160725,8,0.6524999961,135,0.2077037028,143,0.1499999985
20160726,110,0.7039090904,15,0.2020000001,125,0.583814435
20160727,170,0.6929411758,14,0.155000002,184,0.4444017094
20160728,163,0.6304294474,110,0.2351818185,273,0.3933625715
20160729,44,0.693409092,359,0.2404178281,403,0.4986831248
20160730,5,0.8399999738,155,0.2825806459,160,0.498518518
20160731,45,0.7488888754,182,0.2874175818,227,0.4313605417
20160801,107,0.6883177635,96,0.3611458306,203,0.4600000083
20160802,35,0.6382857016,17,0.3352941156,52,0.5265151531
20160803,80,0.6346250005,108,0.240462963,188,0.4862499993
20160804,45,0.6693333348,54,0.2925925941,99,0.4442391257
20160805,62,0.5801612802,85,0.3342352934,147,0.3798324018
20160807,35,0.656571424,35,0.2725714277,70,0.3556307686
20160808,56,0.7228571421,31,0.367419355,87,0.3835000012
20160809,34,0.6438235307,26,0.3173076952,60,0.2612500032
20160810,77,0.6564935043,36,0.2633333339,113,0.5774358945
20160811,132,0.655075756,36,0.288055558,168,0.3898809487
20160812,47,0.7274468123,96,0.2196874987,143,0.3057837853
20160813,31,0.8070967697,119,0.3174789926,150,0.4100714262
20160814,1,0.5400000215,40,0.2575000031,41,0.3545539885
20160815,146,0.6658904067,10,0.2950000018,156,0.2191304334
20160816,69,0.6359420255,23,0.3060869612,92,0.2020000001
20160817,39,0.661538468,62,0.3530645149,101,0.3752173864
20160818,115,0.7329565209,92,0.2395652172,207,0.263474576
20160819,118,0.6933050868,62,0.26032258,180,0.3491258001
20160820,9,0.7544444468,64,0.2203124992,73,0.4972307692
20160821,32,0.669062503,93,0.2359139792,125,0.4494782603
20160822,73,0.6682191744,8,0.1599999983,81,0.465571427
20160823,52,0.6373076874,22,0.2890909039,74,0.8399999738
20160824,67,0.6264179153,93,0.2504301086,160,0.6354838606
20160825,88,0.6745454581,114,0.2200877184,202,0.4633488404
20160826,71,0.5998591504,239,0.2863598324,310,0.4285393217
20160827,1,0.699999988,251,0.2540637457,252,0.4798787877
20160828,41,0.6680487758,89,0.2979775259,130,0.4957500004
20160829,93,0.6637634449,81,0.1909876548,174,0.5092473051
20160830,138,0.6621739108,79,0.2501265812,217,0.5119672117
20160831,91,0.6851648341,70,0.2085714277,161,0.543043478
20160901,144,0.6740972205,82,0.258780489,226,0.4608571447
20160902,72,0.7009722177,99,0.2980808089,171,0.4141040445
20160903,6,0.6316666603,188,0.2097340426,194,0.49501992
20160904,61,0.6891803282,184,0.2353804344,245,0.5113793138
20160905,136,0.6518382391,12,0.2383333376,148,0.682195119
20160906,72,0.6677777709,43,0.2302325583,115,0.3158333387
20160907,127,0.6757480272,192,0.306354168,319,0.5726442274
20160908,64,0.657812494,72,0.2626388902,136,0.4094409922
20160909,45,0.6657777839,94,0.26968085,139,0.4152475267
20160911,30,0.6189999918,47,0.3131914912,77,0.5496648036
20160912,121,0.656280991,94,0.2084042551,215,0.4917061626
20160913,107,0.564112143,56,0.1778571435,163,0.4747058828
20160914,11,0.6963636333,48,0.2752083322,59,0.5142592587
20160915,6,0.7200000087,274,0.2681386847,280,0.4341566255
20160916,3,0.6633333365,191,0.2407329862,194,0.3507831304
20160917,6,0.5683333178,30,0.3313333307,36,0.3608169943
20160918,66,0.6609090829,22,0.1386363606,88,0.3632153407
20160919,40,0.6597500011,64,0.2999999999,104,0.4319374968
20160920,57,0.6184210453,4,0.3524999991,61,0.1971951222
20160921,53,0.6518867961,54,0.3255555552,107,0.3929166643
20160922,131,0.6419083981,89,0.2731460684,220,0.4682822105
20160923,47,0.6917021325,89,0.2805617998,136,0.5118181809
20160924,10,0.7099999785,83,0.2550602413,93,0.4834736841
20160925,51,0.731960784,135,0.2868148167,186,0.4111445776
20160926,28,0.637500003,103,0.1880582513,131,0.3663281234
20160927,80,0.7229999974,8,0.1637500045,88,0.3694444452
20160928,146,0.7067808223,158,0.2572151884,304,0.4994230772
20160929,143,0.691398597,390,0.1883333336,533,0.4496036607
20160930,65,0.6719999891,166,0.1655421691,231,0.4652083306
20161001,11,0.6318181645,412,0.1707524275,423,0.503031671
20161002,3,0.5266666611,269,0.194126395,272,0.5118918891
20161003,79,0.6507594865,97,0.1586597951,176,0.356474822
20161004,214,0.690607473,11,0.093636363,225,0.1778571435
20161005,157,0.7155414003,56,0.2305357152,213,0.4074358936
20161006,143,0.6672727241,74,0.282432434,217,0.3870379734
20161007,150,0.649666663,253,0.2304347833,403,0.3568456364
20161008,24,0.6241666575,380,0.1569473685,404,0.4292682899
20161009,53,0.6320754661,397,0.2077581864,450,0.2632142852
20161010,79,0.6260759446,243,0.2794650204,322,0.3162686568
20161011,72,0.684027772,54,0.3518518521,126,0.4819999903
20161012,136,0.6870588178,195,0.1948717952,331,0.5099999954
20161013,118,0.6238983036,508,0.1972440936,626,0.3930232569
20161014,104,0.6145192282,477,0.167610063,581,0.4124657518
20161015,81,0.5980246906,561,0.262121212,642,0.409705884
20161016,66,0.6098484785,460,0.2178478261,526,0.4616917308
20161017,147,0.6334013554,207,0.2210628003,354,0.3458666674
20161018,233,0.6905579421,197,0.2860406075,430,0.4672222123
20161019,80,0.6471250042,100,0.2354999987,180,0.3730621997
20161020,108,0.6396296289,194,0.2519587613,302,0.2184210531
20161021,37,0.700270271,147,0.2669387769,184,0.3468292678
20161022,7,0.6485714402,172,0.1306395346,179,0.3110035846
20161023,66,0.6431818198,140,0.162571428,206,0.3667233
20161024,76,0.7080263119,67,0.2698507467,143,0.364629626
20161025,119,0.6806722774,6,0.374999995,125,0.3627272639
20161026,180,0.6452222251,130,0.2279230786,310,0.2455932209
20161027,245,0.6379591859,102,0.2427450986,347,0.472614376
20161028,83,0.633614459,132,0.1944696964,215,0.4413062088
20161029,2,0.625,385,0.1539999993,387,0.3202607074
20161030,103,0.7295145572,475,0.2920631565,578,0.3294444436
20161031,60,0.6521666666,190,0.264210526,250,0.4207633573
20161101,132,0.603030305,5,0.2380000025,137,0.435641023
20161102,70,0.6660000009,50,0.2386000019,120,0.2883064507
20161103,94,0.6648936151,84,0.2946428557,178,0.2549574091
20161104,103,0.6832038847,154,0.2049999998,257,0.2353369757
20161105,11,0.6800000017,199,0.2775879376,210,0.3450358668
20161106,125,0.6851199989,64,0.3062500006,189,0.3007439443
20161107,43,0.6481395392,49,0.3265306093,92,0.352636654
20161108,56,0.6844642833,12,0.1541666696,68,0.3769424447
20161109,143,0.641748252,43,0.3567441849,186,0.3843373461
20161110,141,0.6978723428,32,0.2843749973,173,0.4163929588
20161111,105,0.6799047527,251,0.2516733062,356,0.5266842124
20161112,7,0.5614285639,81,0.304567902,88,0.2946031757
20161113,71,0.6978873258,69,0.2652173932,140,0.37032258
20161114,69,0.6392753539,64,0.2832812489,133,0.4229807698
20161115,112,0.6608928554,20,0.2179999992,132,0.5223076963
20161116,100,0.6190000021,61,0.2722950852,161,0.3677551037
20161117,152,0.6956578964,61,0.2914754106,213,0.441404493
20161118,155,0.6676129037,159,0.2653459114,314,0.4249800834
20161119,25,0.7079999924,84,0.3334523806,109,0.3104955757
20161120,116,0.6627586217,48,0.3295833288,164,0.4097638887
20161121,53,0.7122641487,68,0.293676472,121,0.3765201466
20161122,171,0.6342105231,10,0.375,181,0.3485714304
20161123,61,0.7255737674,97,0.1848453613,158,0.569084964
20161124,131,0.6850381735,105,0.2531428573,236,0.4436111103
20161125,41,0.6975609733,88,0.3448863622,129,0.3887062945
20161126,6,0.8333333234,101,0.2566336614,107,0.3786617087
20161127,50,0.615400002,47,0.2700000025,97,0.5196202523
20161128,87,0.70735632,43,0.2253488385,130,0.5682236841
20161129,50,0.7121999991,5,0.4799999893,55,0.4056521763
20161130,129,0.6810852714,91,0.2205494483,220,0.6010714275
20161201,165,0.7548484799,81,0.2787654324,246,0.4929333346
20161202,52,0.682307695,211,0.2772511832,263,0.3306188916
20161204,25,0.7579999924,110,0.2890000008,135,0.519821429
20161205,115,0.6694782672,111,0.3293693694,226,0.5557142879
20161206,128,0.633906246,44,0.2634090908,172,0.5297041359
20161207,58,0.6984482788,4,0.1125000017,62,0.3070370345
20161208,130,0.6493846151,7,0.1657142905,137,0.5012121237
20161209,28,0.7121428549,30,0.261000004,58,0.476076919
20161210,3,0.7733333111,169,0.3069822475,172,0.4288191871
20161211,58,0.7001724068,58,0.2403448283,116,0.4886413054
20161212,90,0.698999995,56,0.2771428578,146,0.6078000002
20161213,205,0.7133170706,44,0.3336363689,249,0.5535874446
20161214,114,0.6994736791,1,0.4799999893,115,0.6128571374
20161215,160,0.6718124952,41,0.2929268298,201,0.4451173716
20161216,73,0.7091780836,74,0.3452702713,147,0.4071518981
20161217,12,0.6583333164,79,0.3720253136,91,0.535907333
20161218,141,0.6946808442,44,0.3334090899,185,0.4332098741
20161219,114,0.677192975,62,0.3572580643,176,0.5754494429
20161220,167,0.705449104,33,0.3069696982,200,0.4558333329
20161221,116,0.6808620707,5,0.4799999893,121,0.672727262
20161222,161,0.7442236021,40,0.2909999997,201,0.3605673752
20161223,73,0.7246575413,58,0.3091379336,131,0.500714285
20161224,23,0.7343478281,59,0.267118646,82,0.3605747111
20161225,34,0.7411764702,67,0.3350746281,101,0.5006276155
20161226,142,0.6730281643,86,0.2498837211,228,0.5837318811
20161227,157,0.6650955373,66,0.3107575761,223,0.4903125014
20161228,70,0.6940000006,5,0.4900000095,75,0.1125000017
20161229,71,0.632957744,6,0.2466666649,77,0.628437495
20161230,26,0.5646153757,77,0.3375324662,103,0.5849655231
20161231,1,0.6200000048,74,0.2167567559,75,0.4478787856
20170101,85,0.6988235326,36,0.3541666689,121,0.4693965535
20170102,275,0.6445454587,32,0.2899999965,307,0.5373118279
20170103,265,0.722075477,39,0.255128205,304,0.4808333357
20170104,345,0.7094202905,35,0.3371428549,380,0.6999999806
20170105,350,0.7722857143,155,0.3400000007,505,0.5315151476
20170106,650,0.6338461527,115,0.3260869594,765,0.5393902416
20170107,80,0.6781250052,165,0.2948484831,245,0.6183802791
20170108,125,0.7395999932,110,0.3504545438,235,0.5975316416
20170109,430,0.7144186032,410,0.4018292678,840,0.5839639605
20170110,170,0.6861764683,20,0.307500001,190,0.5839622655
20170111,285,0.7019298233,20,0.2774999999,305,0.6058823379
20170112,275,0.6319999987,245,0.3167346942,520,0.6054696079
20170113,90,0.6516666611,145,0.3237931008,235,0.5530813913
20170114,5,0.6899999976,290,0.3053448274,295,0.5910177012
20170115,90,0.676111102,315,0.3352380983,405,0.5542622966
20170116,160,0.6915624999,225,0.2064444454,385,0.572105263
20170117,90,0.6277777784,35,0.2128571458,125,0.5281295002
20170118,280,0.629821425,70,0.3207142864,350,0.690714289
20170119,215,0.6353488343,410,0.2201219521,625,0.6669999994
20170120,50,0.6389999986,320,0.28921875,370,0.5550684897
20170121,35,0.6128571459,345,0.3088405809,380,0.5214718584
20170122,80,0.6487500034,270,0.3177777773,350,0.5785849068
20170123,95,0.6526315777,80,0.1849999991,175,0.5264077642
20170124,635,0.6191338587,35,0.2128571432,670,0.3789230734
20170125,395,0.6527848093,80,0.2443749998,475,0.6200000048
20170126,330,0.6409090902,390,0.2174358971,720,0.593333335
20170127,35,0.6042857085,870,0.2812068958,905,0.5347674447
20170128,5,0.6700000167,700,0.2457142854,705,0.6022368466
20170129,55,0.5900000009,360,0.2706944451,415,0.5752941175
20170130,35,0.6399999942,45,0.2477777778,80,0.6714130431
20170131,50,0.6839999974,15,0.2966666669,65,0.5441037727
20170201,210,0.6480952345,15,0.3400000085,225,0.6040000044
20170202,110,0.6840909069,45,0.2488888885,155,0.6758620631
20170203,70,0.6585714306,165,0.3121212132,235,0.5700740733
20170204,5,0.6600000262,260,0.2871153844,265,0.519365077
20170205,60,0.650000001,180,0.3163888892,240,0.5019130428
20170206,170,0.6261764677,145,0.3006896554,315,0.4735593231
20170207,155,0.6370967742,25,0.303999994,180,0.3336507928
20170208,140,0.6510714229,90,0.3072222219,230,0.2725000023
20170209,200,0.6747499987,365,0.2176712339,565,0.5206249952
20170210,75,0.6520000021,275,0.2363636383,350,0.3524561409
20170211,15,0.6099999944,125,0.2184000018,140,0.3635365856
20170212,25,0.6800000072,125,0.3007999992,150,0.452639999
20170213,265,0.6043396187,205,0.2148780511,470,0.4585566995
20170214,115,0.61956522,35,0.1985714284,150,0.3596153835
20170215,175,0.7068571465,100,0.3785,275,0.4128571445
20170216,180,0.56694444,375,0.3070666668,555,0.4465625016
20170217,135,0.6099999944,310,0.3019354833,445,0.3026804119
20170218,85,0.604705877,180,0.2358333322,265,0.4237873751
20170219,175,0.5897142836,290,0.3262068952,465,0.3925570771
20170220,155,0.6258064528,505,0.2484158416,660,0.4477536232
20170221,160,0.6521874964,95,0.3268421033,255,0.4037499975
20170222,250,0.622799996,100,0.2375000011,350,0.3900000043
20170223,305,0.6711475351,255,0.3105882339,560,0.5364285739
20170224,150,0.6189999998,280,0.255714286,430,0.4199999972
20170225,30,0.5866666635,200,0.2664999994,230,0.3986046513
20170226,265,0.6669811325,155,0.2880645166,420,0.4484042536
20170227,350,0.6332857123,230,0.229565217,580,0.4558620683
20170228,235,0.640851063,25,0.3180000037,260,0.4172093031
20170301,110,0.695909091,85,0.3429411755,195,0.3633333327
20170302,225,0.6146666606,155,0.2770967733,380,0.4443333335
20170303,80,0.6399999969,115,0.2821739141,195,0.3474766353
20170304,10,0.7250000238,135,0.2737037047,145,0.3808139547
20170305,40,0.7050000057,235,0.3244680861,275,0.4469811299
20170306,325,0.6810769228,170,0.2282352941,495,0.5309230758
20170307,395,0.6606329121,15,0.2566666603,410,0.331964288
20170308,220,0.6645454561,35,0.2199999999,255,0.3219999982
20170309,115,0.6226086979,255,0.3458823538,370,0.4388000014
20170310,40,0.6762500033,145,0.344482759,185,0.4301562485
20170311,65,0.6053846158,190,0.3447368443,255,0.3878823533
20170312,50,0.7600000024,255,0.3488235276,305,0.4680281703
20170313,275,0.6610909104,70,0.2692857136,345,0.4184042528
20170314,335,0.6853731346,35,0.3971428531,370,0.3246874989
20170315,175,0.6525714295,45,0.3744444466,220,0.4580555521
20170316,350,0.6852857164,155,0.3590322567,505,0.4616363627
20170317,270,0.6642592582,165,0.3106060622,435,0.4297560971
20170318,5,0.5199999809,145,0.2572413804,150,0.3998863625
20170319,85,0.7464705916,150,0.311666667,235,0.464444442
20170320,180,0.6763888829,230,0.3328260859,410,0.5420652136
20170321,365,0.6827397257,30,0.2499999966,395,0.3832894734
20170322,140,0.669642855,30,0.3116666644,170,0.4645454545
20170323,90,0.5983333356,165,0.2703030322,255,0.5882857144
20170324,255,0.6194117665,270,0.380185184,525,0.5239603944
20170325,25,0.5960000038,260,0.3196153843,285,0.5229999996
20170326,105,0.6942857107,185,0.3005405402,290,0.4632653067
20170327,160,0.6546874978,450,0.203111111,610,0.4664130411
20170328,185,0.6310810801,55,0.3309090849,240,0.359999999
20170329,175,0.6494285703,65,0.2853846152,240,0.4440000057
20170330,385,0.6736363629,260,0.2638461533,645,0.4786666696
20170331,95,0.6315789442,230,0.337391301,325,0.5337068968
20170401,10,0.7000000179,155,0.3706451635,165,0.5757407415
20170402,130,0.6926923096,250,0.2994000007,380,0.5163414653
20170403,205,0.6643902427,195,0.2964102555,400,0.4339189184
20170404,150,0.6433333337,20,0.2399999965,170,0.417272728
20170405,260,0.6721153832,140,0.2964285713,400,0.5324999988
20170406,175,0.6648571372,285,0.307368421,460,0.5773684233
20170407,510,0.6285294084,165,0.2593939397,675,0.5522093027
20170408,35,0.595714271,215,0.326976745,250,0.5617000007
20170409,75,0.6386666735,225,0.2922222209,300,0.473437501
20170410,275,0.6578181809,640,0.2441406253,915,0.5732000016
20170411,125,0.636800001,50,0.2269999968,175,0.511799999
20170412,250,0.629399997,55,0.3618181827,305,0.2885714229
20170413,180,0.6536111153,240,0.3212499989,420,0.6330434801
20170414,70,0.6007142833,185,0.235675675,255,0.4821739108
20170415,5,0.5899999738,195,0.3435897441,200,0.5540944875
20170416,105,0.6604761964,155,0.3258064501,260,0.442124999
20170417,285,0.626666666,100,0.2160000005,385,0.3980000005
20170418,185,0.6554054038,15,0.2733333409,200,0.353687944
20170419,170,0.6423529422,45,0.2944444441,215,0.413749997
20170420,370,0.6325675628,175,0.2954285699,545,0.5379411741
20170421,155,0.6619354813,100,0.3374999987,255,0.412738094
20170422,25,0.6860000134,180,0.2891666659,205,0.4683132508
20170423,90,0.6633333299,225,0.3091111102,315,0.5184848489
20170424,240,0.7081249965,170,0.297352941,410,0.5262992125
20170425,230,0.6934782591,35,0.1771428582,265,0.4062068949
20170426,200,0.705749999,25,0.2539999947,225,0.393333337
20170427,605,0.6480991727,155,0.3364516122,760,0.4872222231
20170428,220,0.6581818123,200,0.3029999981,420,0.4567346933
20170429,20,0.574999988,450,0.1967777775,470,0.4422222226
20170430,85,0.742352945,1330,0.2497744357,1415,0.5158947364
20170501,290,0.6829310316,380,0.2959210521,670,0.4552499968
20170502,190,0.6284210525,25,0.2959999993,215,0.4146086943
20170503,130,0.6326923072,90,0.3011111103,220,0.3788235215
20170504,105,0.64190476,195,0.279487179,300,0.5215384659
20170505,20,0.6474999934,250,0.2957999996,270,0.5009708728
20170506,10,0.7699999809,20,0.3149999995,30,0.3974193547
20170507,65,0.7015384482,105,0.3457142867,170,0.5041573019
20170508,120,0.6824999998,40,0.2662500017,160,0.5019403
20170509,45,0.7977777852,5,0.07,50,0.374411764
20170510,175,0.657999997,25,0.2460000038,200,0.3524999991
20170511,265,0.642641505,145,0.2668965518,410,0.5506666707
20170512,235,0.5999999921,30,0.3116666687,265,0.500652173
20170513,20,0.572500005,145,0.2555172414,165,0.5438596476
20170514,120,0.663333334,240,0.3093749996,360,0.4607142858
20170515,65,0.6192307747,335,0.2816417896,400,0.5102520975
20170516,220,0.6495454528,30,0.3366666598,250,0.471230768
20170517,180,0.6741666678,35,0.3571428561,215,0.3891666729
20170518,130,0.6180769228,115,0.3017391282,245,0.5743478222
20170519,200,0.6477500021,170,0.3117647055,370,0.5622784786
20170520,5,0.7300000191,160,0.3075000012,165,0.5118604633
20170521,120,0.6575000013,150,0.26,270,0.3533846149
20170522,250,0.6578000009,205,0.2841463399,455,0.3743152449
20170523,175,0.6474285688,30,0.291666666,205,0.4287499975
20170524,280,0.7226785687,40,0.3274999978,320,0.4199999943
20170525,335,0.6610447729,210,0.3349999981,545,0.5154285728
20170526,165,0.612727272,100,0.3064999972,265,0.5207216476
20170527,25,0.5779999971,155,0.2335483865,180,0.4394318179
20170528,95,0.6273684219,280,0.3014285717,375,0.5903333329
20170529,210,0.6659523816,180,0.305555555,390,0.493809523
20170530,235,0.6829787277,5,0.400000006,240,0.3933333323
20170531,250,0.7171999979,35,0.3599999999,285,0.5366666541
20170601,125,0.6980000019,205,0.3360975601,330,0.5749999914
20170602,35,0.6085714272,145,0.3324137939,180,0.4550943396
20170604,105,0.64238095,135,0.3399999997,240,0.6033333386
20170605,65,0.6076923059,165,0.2518181809,230,0.4756249986
20170606,115,0.643043471,170,0.3038235284,285,0.4842574232
20170607,190,0.74236842,10,0.3100000024,200,0.4128947327
20170608,105,0.6542857204,25,0.2780000009,130,0.430999998
20170609,150,0.6833333333,110,0.3490909092,260,0.594193549
20170610,20,0.674999997,80,0.3943750011,100,0.4163888895
20170611,80,0.6312500052,195,0.2879487188,275,0.5023076912
20170612,155,0.6577419331,105,0.2390476188,260,0.5016176482
20170613,415,0.6665060211,75,0.3080000002,490,0.4262499999
20170614,250,0.6283999968,5,0.349999994,255,0.463703704
20170615,235,0.659148934,35,0.2728571434,270,0.3542857165
20170616,60,0.5808333258,110,0.2845454532,170,0.5750000004
20170617,15,0.6566666762,200,0.3529999977,215,0.5104347823
20170618,95,0.6763157907,155,0.3183870949,250,0.5234545427
20170619,140,0.690714283,125,0.3379999997,265,0.5483908027
20170620,255,0.6888235246,95,0.2657894747,350,0.4973170715
20170621,110,0.6913636354,5,0.1199999973,115,0.4524637674
20170622,205,0.6634146324,40,0.3574999971,245,0.5483333319
20170623,150,0.6379999995,165,0.240606059,315,0.555384616
20170624,15,0.5699999928,150,0.3133333318,165,0.503012048
20170625,85,0.616470589,190,0.30368421,275,0.5492105293
20170626,195,0.6897435861,105,0.2642857172,300,0.5849350635
20170627,145,0.718965516,120,0.3358333331,265,0.4441379314
20170628,280,0.6841071408,20,0.2349999994,300,0.3558536574
20170629,220,0.6524999995,55,0.226363639,275,0.3100000024
20170630,120,0.7391666646,110,0.3154545446,230,0.5723076905
20170701,15,0.6333333254,80,0.2899999984,95,0.4451428565
20170702,70,0.6542857076,215,0.299069767,285,0.541025637
20170703,265,0.6735849054,110,0.3722727265,375,0.5122077924
20170704,270,0.6520370377,80,0.2675000025,350,0.4466666696
20170705,290,0.7332758616,140,0.1867857155,430,0.558222222
20170706,135,0.6903703698,155,0.226774194,290,0.6099999964
20170707,580,0.6704310353,320,0.2609375007,900,0.522173917
20170708,55,0.689090908,170,0.3250000013,225,0.5028301867
20170709,85,0.72823529,245,0.2781632646,330,0.5645528428
20170710,275,0.693999996,375,0.2670666663,650,0.5097530837
20170711,250,0.6828000021,85,0.3176470571,335,0.5476388874
20170712,245,0.69265306,50,0.2790000003,295,0.3877419332
20170713,235,0.6448936183,185,0.3689189192,420,0.5225000065
20170714,260,0.7076923091,170,0.2923529392,430,0.5818518519
20170715,70,0.6464285765,155,0.2580645147,225,0.4472131125
20170716,45,0.6477777825,180,0.3480555535,225,0.5497530828
20170717,220,0.6565909101,285,0.280175438,505,0.4458333324
20170718,305,0.611967213,45,0.2633333322,350,0.528225806
20170719,145,0.6344827578,145,0.256896553,290,0.503703703
20170720,135,0.6799999983,140,0.2882142847,275,0.3785714252
20170721,100,0.6465000033,330,0.295757576,430,0.4632142873
20170722,10,0.5550000072,200,0.3197500017,210,0.5547540957
20170723,35,0.6585714306,80,0.2475000005,115,0.5664444431
20170724,200,0.6605000004,105,0.291904765,305,0.5168686855
20170725,175,0.6462857144,10,0.3999999911,185,0.5590909085
20170726,205,0.6409756091,50,0.3020000003,255,0.5504999998
20170727,560,0.655446423,150,0.2793333336,710,0.6333333254
20170728,235,0.6921276577,120,0.2654166648,355,0.342619046
20170729,40,0.6662499905,375,0.1849333348,415,0.5086904761
20170730,140,0.6992857158,710,0.2948591535,850,0.4399152549
20170731,120,0.6245833362,240,0.2647916654,360,0.5823913045
20170801,145,0.6510344846,15,0.1933333327,160,0.4246052625
20170802,100,0.6050000042,10,0.2849999964,110,0.5120418852
20170803,125,0.6128000045,140,0.2225000001,265,0.4635714269
20170804,40,0.6687500104,225,0.285777777,265,0.5618518496
20170805,5,0.8199999928,275,0.2450909087,280,0.5632608673
20170806,35,0.6157142861,155,0.2899999984,190,0.524761905
20170807,140,0.6453571405,85,0.3400000016,225,0.524249999
20170808,40,0.6462500021,15,0.2466666698,55,0.5161445782
20170809,225,0.6408888883,40,0.383750001,265,0.4841284407
20170810,200,0.6822500035,290,0.3174137922,490,0.4965217418
20170811,60,0.640833338,185,0.278918915,245,0.3494736863
20170813,65,0.7423076951,135,0.2692592599,200,0.5133333336
20170814,120,0.6408333282,245,0.1957142868,365,0.4476377953
20170815,135,0.6544444495,135,0.2670370392,270,0.4520289862
20170816,95,0.6557894726,15,0.083333335,110,0.5190697666
20170817,350,0.6675714305,60,0.2041666669,410,0.4648780517
20170818,155,0.6012903221,215,0.2651162795,370,0.4774999991
20170819,25,0.6720000029,55,0.2590909085,80,0.4488235304
20170820,195,0.7135897432,190,0.2594736841,385,0.4971428575
20170821,240,0.678124999,185,0.2767567562,425,0.4913559315
20170822,165,0.6503030315,105,0.2323809514,270,0.3461206904
20170823,170,0.694705886,10,0.4799999893,180,0.4538582644
20170824,370,0.678243241,115,0.340869568,485,0.4762105247
20170825,240,0.5893749992,130,0.2430769219,370,0.5372727202
20170826,5,0.6899999976,95,0.266842105,100,0.6716666679
20170827,100,0.6810000002,160,0.3200000008,260,0.4080769245
20170828,320,0.6406249972,195,0.306666665,515,0.4289189192
20170829,195,0.655128207,490,0.2971428568,685,0.3410666675
20170830,175,0.6534285716,30,0.1566666669,205,0.434107144
20170831,195,0.742820509,80,0.2975000027,275,0.4452000044
20170901,125,0.6332000017,345,0.277536231,470,0.3900000006
20170902,60,0.687500005,360,0.1609722219,420,0.4920000007
20170903,40,0.7174999937,695,0.2076258994,735,0.4241860451
20170904,160,0.7112500016,165,0.2469696956,325,0.3442222194
20170905,210,0.6664285717,265,0.3132075485,475,0.501527778
20170906,190,0.6544736828,45,0.1733333324,235,0.4143820247
20170907,210,0.6295238109,45,0.2133333339,255,0.382051285
20170908,100,0.6229999989,110,0.2018181797,210,0.083333335
20170909,5,0.5299999714,260,0.1807692306,265,0.4840000015
20170910,95,0.6163157821,135,0.2625925898,230,0.399701491
20170911,205,0.6456097539,200,0.3044999991,405,0.5400000034
20170912,165,0.6454545404,290,0.3248275855,455,0.3915789469
20170913,175,0.6688571487,50,0.1429999989,225,0.5324299076
20170914,310,0.6588709672,90,0.3099999987,400,0.4523076916
20170915,155,0.6219354849,230,0.3152173906,385,0.6171428561
20170916,20,0.5474999845,190,0.2578947357,210,0.5753225814
20170917,110,0.7027272663,80,0.267499998,190,0.525270269
20170918,255,0.6678431373,235,0.3536170207,490,0.5101923083
20170919,355,0.6660563375,100,0.2994999999,455,0.5130303053
20170920,220,0.6518181806,20,0.2574999938,240,0.5499999978
20170921,250,0.6789999974,55,0.2254545467,305,0.3932191776
20170922,140,0.665,155,0.3354838684,295,0.2328571427
20170923,5,0.7799999714,190,0.242894734,195,0.5105555569
20170924,115,0.6795652172,230,0.3150000009,345,0.4522556373
20170925,315,0.7065079345,190,0.3531578967,505,0.3345945951
20170926,260,0.6642307685,75,0.3666666664,335,0.2972988507
20170927,175,0.645142857,15,0.2033333344,190,0.5155555529
20170928,230,0.663478263,50,0.3219999999,280,0.4157692322
20170929,55,0.7072727301,75,0.3546666667,130,0.4671428596
20170930,10,0.5799999833,145,0.2710344818,155,0.4505882327
20171001,10,0.6450000107,185,0.3245945925,195,0.5037037038
20171002,30,0.7083333433,140,0.3585714273,170,0.3977659575
20171003,10,0.5399999917,50,0.3580000028,60,0.4916923057
20171004,30,0.7366666694,45,0.3844444421,75,0.47097561
20171005,15,0.6433333158,30,0.321666669,45,0.4012820505
20171006,5,0.6200000048,25,0.3099999994,30,0.1781818145
20171007,15,0.7399999897,5,0.4099999964,20,0.4672972928
20171008,75,0.6146666646,20,0.257500004,95,0.4709195388
20171009,165,0.6393939401,10,0.2400000021,175,0.438028166
20171010,240,0.683124998,30,0.2350000013,270,0.5429411799
20171011,315,0.6671428586,10,0.2649999931,325,0.5272477059
20171012,255,0.7158823551,5,0.1000000015,260,0.4954901967
20171013,475,0.6922105262,65,0.3499999958,540,0.4024999891
20171014,50,0.6819999933,195,0.300512817,245,0.5436363598
20171015,90,0.7055555615,235,0.2397872323,325,0.542195121
20171016,165,0.6287878788,150,0.3046666652,315,0.5185321088
20171017,235,0.64255319,595,0.268571429,830,0.4796666666
20171018,195,0.6623076934,80,0.2831250002,275,0.538295454
20171019,255,0.6519607773,40,0.3575000018,295,0.5609302326
20171020,160,0.6446874999,280,0.3166071434,440,0.3474999936
20171021,15,0.6033333341,155,0.2970967734,170,0.571212121
20171022,95,0.728421058,105,0.3142857121,200,0.6388461522
20171023,250,0.6473999953,270,0.2592592581,520,0.5234567893
20171024,190,0.6692105249,90,0.291111108,280,0.4804166654
20171025,170,0.6535294161,5,0.270000011,175,0.548108109
20171026,465,0.6183870967,30,0.3216666629,495,0.5409523838
20171027,140,0.6296428527,155,0.3012903219,295,0.419999995
20171028,10,0.5849999785,170,0.3261764703,180,0.4025000045
20171029,110,0.62545454,180,0.2936111115,290,0.5272727324
20171030,305,0.6754098368,430,0.3197674417,735,0.4966666599
20171031,860,0.6311627886,185,0.3164864883,1045,0.5450000033
20171101,550,0.6509999985,25,0.2939999983,575,0.4819999903
20171102,575,0.6435652168,50,0.3259999961,625,0.290000002
20171103,195,0.6584615356,195,0.3051282038,390,0.5499999911
20171104,10,0.699999988,820,0.3268902439,830,0.5824999982
20171105,65,0.6630769234,410,0.3209756088,475,0.557608695
20171106,220,0.6356818202,320,0.3090624995,540,0.5116091927
20171107,120,0.6362500042,185,0.304864864,305,0.4845454546
20171108,175,0.6671428544,20,0.2100000009,195,0.5635802477
20171109,185,0.6764864825,70,0.3157142853,255,0.4566355143
20171110,110,0.6704545455,170,0.3232352944,280,0.4365384591
20171111,10,0.7400000095,120,0.2575000009,130,0.5984615431
20171112,135,0.6866666697,130,0.3223076921,265,0.4323595509
20171113,120,0.6845833287,165,0.2906060621,285,0.505256409
20171114,195,0.6328205176,125,0.3755999978,320,0.5405
20171115,265,0.6532075484,5,0.4399999976,270,0.449999996
20171116,680,0.6586764709,50,0.2130000003,730,0.5173999989
20171117,270,0.6437037035,90,0.3405555549,360,0.5200000033
20171118,65,0.6823076927,195,0.2935897435,260,0.6308000028
20171119,130,0.706923077,215,0.3267441836,345,0.5149382685
20171120,180,0.717222222,310,0.3509677416,490,0.507222221
20171121,140,0.7782142865,185,0.3499999992,325,0.4684285738
20171122,225,0.6626666625,35,0.335714287,260,0.474916201
20171123,165,0.6763636289,45,0.3411111087,210,0.4513846145
20171124,115,0.6673913028,135,0.2988888876,250,0.37714285
20171126,190,0.6852631553,110,0.3245454562,300,0.5318749947
20171127,115,0.7134782594,250,0.3077999984,365,0.531
20171128,225,0.6048888842,200,0.2930000003,425,0.4826488085
20171129,325,0.654615383,110,0.3504545488,435,0.5100520821
20171130,200,0.6680000052,25,0.2299999997,225,0.5239664799
20171201,85,0.645294123,45,0.4277777738,130,0.4863157876
20171202,25,0.6620000243,380,0.2259210538,405,0.37333333
20171203,90,0.6583333313,540,0.2702777784,630,0.4829629629
20171204,105,0.6780952329,350,0.2637142861,455,0.4994871807
20171205,150,0.6326666653,225,0.2291111114,375,0.446875003
20171206,210,0.6616666672,185,0.2891891881,395,0.520163933
20171207,200,0.6750000015,20,0.1949999966,220,0.4945714271
20171208,80,0.700000003,65,0.2853846156,145,0.5136170201
20171209,10,0.8149999976,230,0.2893478257,240,0.6400000056
20171210,75,0.6333333294,360,0.2272222237,435,0.5586486509
20171211,170,0.6976470579,215,0.2744186055,385,0.5371428542
20171212,250,0.654799999,180,0.2883333338,430,0.4632051305
20171213,165,0.6390909047,85,0.2864705894,250,0.5069791662
20171214,175,0.6599999973,20,0.2050000029,195,0.5623232324
20171215,170,0.697941177,70,0.2135714303,240,0.5242857138
20171216,140,0.696071425,240,0.2295833331,380,0.5610000007
20171217,140,0.6864285746,210,0.3535714301,350,0.6128571421
20171218,185,0.685135133,105,0.2961904728,290,0.5379365073
20171219,145,0.6551724056,135,0.2944444437,280,0.5786000011
20171220,425,0.6769411788,70,0.3185714294,495,0.475894734
20171221,285,0.6892982439,15,0.3666666647,300,0.466301367
20171222,185,0.6575675671,10,0.375,195,0.5124444453
20171223,10,0.6299999952,160,0.3450000002,170,0.2299999997
20171224,10,0.599999994,225,0.3446666688,235,0.635957444
20171225,50,0.725999999,290,0.2922413803,340,0.3391919198
20171226,75,0.6886666695,245,0.233265304,320,0.3686928095
20171227,130,0.6857692347,150,0.2983333355,280,0.4519259253
20171228,195,0.6841025658,90,0.1416666682,285,0.4356470614
20171229,100,0.7450000048,25,0.1260000028,125,0.4012962972
20171231,25,0.6580000043,60,0.1916666656,85,0.4544444564
20180101,50,0.7679999948,135,0.2722222209,185,0.5019354828
20180102,140,0.6471428509,200,0.313499999,340,0.4111940279
20180103,105,0.6166666661,190,0.2760526291,295,0.3464705889
20180104,130,0.6453846143,50,0.2759999968,180,0.465764707
20180105,75,0.6259999911,25,0.311999993,100,0.4918421063
20180106,10,0.7450000048,15,0.2366666626,25,0.486969699
20180107,70,0.6492857082,15,0.3433333387,85,0.4083333345
20180108,150,0.698333337,110,0.2199999991,260,0.430689654
20180109,190,0.6813157891,195,0.2217948721,385,0.423658536
20180110,120,0.694583332,115,0.2556521744,235,0.5172826089
20180111,105,0.6619047608,95,0.3063157882,200,0.5057407367
20180112,65,0.6823076927,20,0.3024999928,85,0.5008064498
20180113,5,0.7400000095,25,0.3320000019,30,0.5872916673
20180114,80,0.661250003,125,0.3247999971,205,0.6641935447
20180115,175,0.6342857139,75,0.3026666649,250,0.6656666696
20180116,215,0.6516279093,185,0.3216216213,400,0.5273913031
20180117,190,0.6510526271,100,0.299999999,290,0.4663513494
20180118,95,0.6521052655,30,0.3433333337,125,0.5209090927
20180119,35,0.645714283,35,0.2957142879,70,0.4784905641
20180121,15,0.7066666683,120,0.2974999986,135,0.4967164187
20180122,140,0.6882142808,180,0.316111111,320,0.1905000009
20180123,95,0.7036842076,120,0.3229166643,215,0.2614285717
20180124,125,0.67,95,0.3178947384,220,0.4345454536
20180125,185,0.6518918936,90,0.2522222216,275,0.4209523811
20180126,170,0.6276470563,15,0.1733333332,185,0.4601515161
20180127,15,0.649999996,10,0.3699999899,25,0.4827272724
20180128,25,0.6919999957,145,0.3127586186,170,0.5886666688
20180129,45,0.718888885,100,0.2484999998,145,0.311999993
20180130,55,0.70636364,230,0.2449999985,285,0.5000000012
20180131,130,0.6588461537,440,0.1988636366,570,0.6699999972
20180201,16,0.5768749975,250,0.2534000004,266,0.4591999961
20180202,10,0.6289999962,35,0.2614285664,45,0.36
20180203,3,0.6800000072,10,0.4050000012,13,0.4624489792
20180204,19,0.6505263165,85,0.2147058865,104,0.4473529365
20180205,17,0.6552941168,50,0.3160000026,67,0.449999997
20180206,15,0.609333332,70,0.2735714282,85,0.5657894697
20180207,16,0.6068750024,23,0.2956521744,39,0.5285454552
20180208,23,0.6604347851,16,0.3349999997,39,0.5741509426